20 20
180 150
2 2 2 2 2 2 2 2 2 2 2 2 2 2 2 2 2 2 2 2
2 0 0 0 0 0 0 0 0 0 0 0 0 0 0 0 0 0 1 2
2 0 0 0 2 2 2 2 2 2 2 2 2 2 0 0 0 0 1 2
2 0 0 0 2 0 0 0 0 0 0 0 0 2 0 0 0 0 1 2
2 0 0 0 1 1 1 1 1 1 1 1 1 1 0 0 0 0 1 2
2 0 0 0 2 1 1 1 1 1 1 0 0 2 0 0 0 0 1 2
2 0 0 0 2 0 1 1 1 1 1 1 0 2 0 0 0 0 1 2
2 0 0 0 2 0 0 1 1 1 1 2 2 2 0 0 0 0 1 2
2 1 0 0 2 0 1 1 1 1 1 2 2 2 0 0 0 0 1 2
2 1 0 0 2 2 2 2 1 1 1 2 2 2 0 0 0 0 1 2
2 1 0 0 2 2 2 2 2 2 0 2 2 2 0 0 0 0 1 2
2 1 0 0 0 0 0 0 0 0 0 0 0 0 0 0 0 0 1 2
2 1 0 0 0 0 0 0 0 0 0 0 0 0 0 0 0 0 1 2
2 1 0 0 0 0 1 1 1 1 1 1 0 0 0 0 2 2 1 2
2 1 0 0 0 0 0 0 1 1 1 0 0 0 0 2 2 0 1 2
2 1 0 0 0 0 0 0 0 1 0 1 1 0 2 2 0 0 1 2
2 1 0 0 0 0 0 0 1 1 1 1 1 1 2 0 0 0 1 2
2 1 0 0 0 0 0 0 1 1 0 1 1 1 1 0 0 0 1 2
2 1 0 0 0 0 0 0 0 0 0 0 0 0 0 0 0 0 1 2
2 2 2 2 2 2 2 2 2 2 2 2 2 2 2 2 2 2 2 2


18 1

2 2 2 2 2 2 2 2 2 2 2 2 2 2 2 2 2 2 2 2
2 0 0 0 0 0 8 9 5 5 5 8 3 3 3 3 3 3 9 2
2 0 0 0 2 2 2 2 2 2 2 2 2 2 8 3 9 0 8 2
2 0 0 0 2 0 0 0 0 8 3 9 0 2 0 0 8 3 9 2
2 8 9 0 8 3 9 0 0 3 0 0 0 0 1 3 0 0 0 2
2 1 0 0 2 8 9 0 0 3 4 0 0 2 0 3 0 3 0 2
2 1 0 0 2 0 3 5 5 5 3 0 0 2 8 3 3 3 9 2
2 1 0 0 2 0 0 1 4 1 0 2 2 2 8 9 0 0 0 2
2 4 4 0 2 0 0 1 1 1 0 2 2 2 8 9 3 0 0 2
2 8 3 9 2 2 2 2 0 0 0 2 2 2 0 0 3 1 0 2
2 3 0 0 2 2 2 2 2 2 0 2 2 2 0 0 0 1 0 2
2 0 3 0 0 0 0 0 8 3 9 0 5 5 5 0 0 3 0 2
2 0 3 0 8 3 9 0 8 3 3 3 3 9 0 1 1 8 9 2
2 0 8 3 3 9 5 5 8 3 9 0 0 0 0 0 2 2 0 2
2 0 8 3 9 0 0 0 0 1 3 0 0 0 0 2 2 4 0 2
2 0 8 3 3 3 3 9 0 0 8 9 0 0 2 2 4 0 0 2
2 0 0 8 3 3 3 9 0 8 9 1 8 9 2 1 1 3 0 2
2 0 0 8 3 3 3 9 0 0 0 8 3 3 9 0 8 3 9 2
2 0 0 0 0 0 0 0 0 0 0 0 8 9 0 0 8 3 9 2
2 2 2 2 2 2 2 2 2 2 2 2 2 2 2 2 2 2 2 2

0