20 20
1024 1024
2 2 2 2 2 2 2 2 2 2 2 2 2 2 2 2 2 2 2 2
2 0 0 0 0 0 0 0 0 0 0 0 0 0 0 0 0 0 0 2
2 0 2 0 2 0 2 0 2 0 2 0 2 0 2 0 2 0 2 2
2 0 0 0 0 0 0 0 0 0 0 0 0 0 0 0 0 0 0 2
2 2 0 2 0 2 0 2 0 2 0 2 0 2 0 2 0 2 0 2
2 0 0 0 0 0 0 0 0 0 0 0 0 0 0 0 0 0 0 2
2 0 2 0 2 0 2 0 2 0 2 0 2 0 2 0 2 0 2 2
2 0 0 0 0 0 0 0 0 0 0 0 0 0 0 0 0 0 0 2
2 0 0 0 0 0 0 0 0 0 0 0 0 0 0 0 0 0 0 2
2 0 2 2 2 2 2 2 0 2 0 0 0 0 0 0 0 0 0 2
2 0 0 0 0 0 0 0 0 2 0 0 0 2 0 2 0 2 0 2
2 0 0 0 0 0 0 0 0 2 2 0 0 0 0 0 0 0 0 2
2 0 2 0 0 2 0 0 0 2 2 0 0 0 2 2 0 0 0 2
2 0 0 0 0 0 0 0 0 2 2 0 0 0 0 0 0 0 0 2
2 0 0 0 0 0 0 0 0 2 2 0 0 0 0 0 0 0 0 2
2 0 2 0 2 0 2 0 2 0 2 0 2 0 2 2 2 0 0 2
2 0 0 0 0 0 0 0 0 0 0 0 0 0 0 2 0 0 0 2
2 0 2 0 2 0 2 0 2 0 2 0 2 0 0 2 0 0 0 2
2 0 0 0 0 0 0 0 0 0 0 0 0 0 0 2 0 0 0 2
2 2 2 2 2 2 2 2 2 2 2 2 2 2 2 2 2 2 2 2

5 10

2 2 2 2 2 2 2 2 2 2 2 2 2 2 2 2 2 2 2 2
2 5 5 1 1 1 1 1 0 0 8 9 0 4 0 4 0 4 0 2
2 5 2 3 2 3 2 3 2 3 2 3 2 3 2 3 2 3 2 2
2 1 1 1 8 3 3 9 5 5 0 0 0 8 3 3 3 3 9 2
2 2 3 2 4 2 3 2 3 2 3 2 0 2 4 2 4 2 5 2
2 5 5 4 5 5 8 9 0 0 1 1 1 1 1 0 0 0 5 2
2 3 2 3 2 3 2 3 2 0 2 0 2 0 2 0 2 0 2 2
2 3 5 3 5 1 1 1 4 1 8 3 3 3 3 3 3 3 9 2
2 1 1 0 0 4 4 4 1 1 0 0 0 8 3 3 3 3 9 2
2 1 2 2 2 2 2 2 1 2 1 1 1 1 1 0 0 0 5 2
2 1 1 0 0 3 4 4 4 2 8 3 9 2 3 2 3 2 5 2
2 1 1 1 1 4 4 4 0 2 2 0 0 0 1 0 1 3 5 2
2 0 2 0 0 2 8 3 9 2 2 5 5 3 2 2 0 5 3 2
2 8 3 9 1 1 1 1 0 2 2 5 8 3 9 0 0 5 3 2
2 8 3 3 3 9 5 5 1 2 2 5 0 0 0 1 1 1 3 2
2 3 2 3 2 0 2 1 2 4 2 4 2 4 2 2 2 4 3 2
2 3 3 3 0 0 1 1 1 3 0 1 0 0 0 2 0 0 3 2
2 3 2 3 2 3 2 3 2 3 2 0 2 0 0 2 0 0 3 2
2 8 3 3 9 0 0 0 3 3 4 4 4 0 0 2 0 0 0 2
2 2 2 2 2 2 2 2 2 2 2 2 2 2 2 2 2 2 2 2

4
1024 320
832 1024
640 512
320 1024