20 20
180 150
2 2 2 2 2 2 2 2 2 2 2 2 2 2 2 2 2 2 2 2
2 3 3 3 3 3 3 3 3 3 3 3 3 3 3 3 3 3 3 2
2 3 3 3 2 2 2 2 2 2 2 2 2 2 3 3 3 3 3 2
2 3 3 3 2 3 3 3 3 3 3 3 3 2 3 3 3 3 3 2
2 3 3 3 3 3 3 3 3 3 3 3 3 3 3 3 3 3 3 2
2 3 3 3 2 3 3 3 3 3 3 3 3 2 3 3 3 3 3 2
2 3 3 3 2 3 3 3 3 3 3 3 3 2 3 3 3 3 3 2
2 3 3 3 2 3 3 3 3 3 3 2 2 2 3 3 3 3 3 2
2 3 3 3 2 3 3 3 3 3 3 2 2 2 3 3 3 3 3 2
2 3 3 3 2 2 2 2 3 3 3 2 2 2 3 3 3 3 3 2
2 3 3 3 2 2 2 2 2 2 3 2 2 2 3 3 3 3 3 2
2 3 3 3 3 3 3 3 3 3 3 3 3 3 3 3 3 3 3 2
2 3 3 3 3 3 3 3 3 3 3 3 3 3 3 3 3 3 3 2
2 3 3 3 3 3 3 3 3 3 3 3 3 3 3 3 2 2 3 2
2 3 3 3 3 3 3 3 3 3 3 3 3 3 3 2 2 3 3 2
2 3 3 3 3 3 3 3 3 3 3 3 3 3 2 2 3 3 3 2
2 3 3 3 3 3 3 3 3 3 3 3 3 3 2 3 3 3 3 2
2 3 3 3 3 3 3 3 3 3 3 3 3 3 3 3 3 3 3 2
2 3 3 3 3 3 3 3 3 3 3 3 3 3 3 3 3 3 3 2
2 2 2 2 2 2 2 2 2 2 2 2 2 2 2 2 2 2 2 2

18 1

2 2 2 2 2 2 2 2 2 2 2 2 2 2 2 2 2 2 2 2
2 0 0 0 0 0 3 3 5 5 5 3 3 3 3 3 3 3 3 2
2 0 0 0 2 2 2 2 2 2 2 2 2 2 3 3 3 0 3 2
2 0 0 0 2 0 0 0 0 3 3 3 0 2 0 0 3 3 3 2
2 3 3 0 3 3 3 0 0 3 0 0 0 0 6 3 0 0 0 2
2 6 0 0 2 3 3 0 0 3 7 0 0 2 0 3 0 3 0 2
2 6 0 0 2 0 3 5 5 5 3 0 0 2 3 3 3 3 3 2
2 6 0 0 2 0 0 6 7 6 0 2 2 2 3 3 0 0 0 2
2 7 7 0 2 0 0 6 6 6 0 2 2 2 3 3 3 0 0 2
2 3 3 3 2 2 2 2 0 0 0 2 2 2 0 0 3 6 0 2
2 3 0 0 2 2 2 2 2 2 0 2 2 2 0 0 0 6 0 2
2 0 3 0 0 0 0 0 3 3 3 0 5 5 5 0 0 3 0 2
2 0 3 0 3 3 3 0 3 3 3 3 3 3 0 6 6 3 3 2
2 0 3 3 3 3 5 5 3 3 3 0 0 0 0 0 2 2 0 2
2 0 3 3 3 0 0 0 0 6 3 0 0 0 0 2 2 7 0 2
2 0 3 3 3 3 3 3 0 0 3 3 0 0 2 2 7 0 0 2
2 0 0 3 3 3 3 3 0 3 3 6 3 3 2 6 6 3 0 2
2 0 0 3 3 3 3 3 0 0 0 3 3 3 3 0 3 3 3 2
2 0 0 0 0 0 0 0 0 0 0 0 3 3 0 0 3 3 3 2
2 2 2 2 2 2 2 2 2 2 2 2 2 2 2 2 2 2 2 2

2
200 700
500 300